R 1300 700

NO ./path_to_the_north_texture

SO ./path_to_the_south_texture

WE ./path_to_the_west_texture

EA ./path_to_the_east_texture

S ./path_to_the_sprite_texture

F 255,255,255

C 0,0,0

             1111111111
             1000000001
             1000000001
            11000000011
            1000000001
1111111111111000000011
101000100010000000001
101010000000100E00001
100010001000000000001
111111111111111111111