NO ./srcs/sssr.xpm
WE ./srcs/ne-dushi.xpm 

SO      ./srcs/you.xpm

EA ./srcs/checklist.xpm

S ./srcs/lensin.xpm

F 35 , 155, 127

C 200, 200,200
R 863 863

         1111111111111
           1000000001
        11110000000011111111
1           11000000011
1          1000000001
1111111111111000000011
1010000222222222222221
1000000000000E0001001
10001000000000001001
1222222222222222221
1222222222222222221
1222222222222222221
1222222222222222221
1222222222222222221
1222222222222222221
1222222222222222221
1222222222222222221
1222222222222222221
1222222222222222221
1222222222222222221
1222222222222222221
1222222222222222221
1222222222222222221
1222222222222222221
1222222222222222221
1222222222222222221
1222222222222222221
1222222222222222221
1222222222222222221
1222222222222222221
1222222222222222221
1222222222222222221
1222222222222222221
1222222222222222221
1222222222222222221
1222222222222222221
1222222222222222221
1222222222222222221
1222222222222222221
1222222222222222221
1222222222222222221
1222222222222222221
1222222222222222221
1222222222222222221
1222222222222222221
1222222222222222221
1222222222222222221
1222222222222222221
1222222222222222221
1222222222222222221
1222222222222222221
1222222222222222221
1222222222222222221
1222222222222222221
1222222222222222221
1222222222222222221
1222222222222222221
1222222222222222221
1222222222222222221
1222222222222222221
1222222222222222221
1222222222222222221
1222222222222222221
1111111111111111111  